Andropogen  -> Andropogon
Anfung -> Anfang
Annona  -> Anona
Anschauug -> Anschauung
Arggreia -> Argyrea
Artocar pus -> Artocarpus
Attributen¤u.s.w  -> Attributen u.s.w.
Aufenthalsort -> Aufenthaltsort
Baringtonia -> Barringtonia
Befreigung -> Befreiung
Befähi -> Befähigung
Beredtsamkeit ->  Beredsamkeit
Beschäwung -> Beschämung
Besonnenbeit -> Besonnenheit
Betenussbaum -> Betelnussbaum
Bewillkommung -> Bewillkommnung
Comerad -> Camerad
Donnerkeit -> Donnerkeil
Donnerkeits -> Donnerkeils
Durchboren -> Durchbohren ;; print error
Eheman -> Ehemann ;; print error
Einkänfte -> Einkünfte
Eundament -> Fundament
Fehl geburt -> Fehlgeburt
Feid -> Feind
Fluchthun -> Fluch thun
Fluchtschlagen -> Flucht schlagen
Flussalz -> Flusssalz
Gebirgssladt -> Gebirgsstadt
Gemüthsoffecten -> Gemüthsaffecten
Genetiv -> Genitiv
Genugthung -> Genugthuung
Ggnaeceum -> Gynaeceum
Grundpfichten -> Grundpflichten
Herkunfl -> Herkunft
Herzsetzend -> Herz setzend
Hincha  -> Hingcha
Iöpfer -> Töpfer
Jederman  -> Jedermann
Kindisch -> kindisch
Rewegung ->  Bewegung
Schwefelktes -> Schwefelkies
Seelle -> Seele
Suck -> Sack
Theii -> Theil
Their -> Thier
Tieger -> Tiger
Tiegerfell -> Tigerfell
Tolltheit -> Tollheit
Traunkenheit -> Trunkenheit
Uberwältigen -> Ueberwältigen
Unheii -> Unheil
Verhauf -> Verkauf
Verhälltniss -> Verhältniss
Verleicher -> Verleiher
Vernic?ten -> Vernichten [h statt unicode U+1E25] ;;
Verschein -> Vorschein
Vogethaus -> Vogelhaus
Vorsehein -> Vorschein
Vorshein -> Vorschein
Vorzuglichkeit -> Vorzüglichkeit
Wagenschüppen -> Wagenschuppen
Waldchen -> Wäldchen
Weehsel -> Wechsel
Widersprueh -> Widerspruch
Wiedderzusammenkommen -> Wiederzusammenkommen
Wiederzukommtenlassen -> Wiederzukommenlassen
Wochnerinnen -> Wöchnerinnen
Wohlfart -> Wohlfahrt
Wöhnung -> Wohnung
Wöterbuchs -> Wörterbuch
Wünsehen -> Wünschen
Zuscht -> Zucht
Zustromen -> Zuströmen
Zweizungigkeit -> Zweizüngigkeit
abge schnittenes -> abgeschnittenes
- abtheilung -> -abtheilung
abtropfeln -> abtröpfeln
zu andern und -> zu ändern und
anhangend -> anhängend
ansserhalb -> ausserhalb
aprés -> après
ascertainement -> ascertainment
ascéte ->  ascète
aufdie-Probe-Stellen -> das auf-die-Probe-Stellen
aufkeine -> auf keine
befriedrigt -> befriedigt
condolance -> condolence [misprint]
cordifoliuss -> cordifolius
dioica -> dioeca
dretäugig -> dreiäugig
durchwändern -> durchwandern
einziekend -> einziehend
entchlossen -> entschlossen
enterhrender -> entehrender
entstandt -> entsandt
geoflenbarten -> geoffenbarten
herrühend -> herrührend
herrühende -> herrührende
hest. -> best.
hinaufblücken -> hinaufblicken
hineigegangen -> hineingegangen
hommend -> kommend
horen. -> hören,
hülend -> hütend
inseine-Gewalt-bekommen -> in-seine-Gewalt-Bekommen
lebenfähig -> lebensfähig
mit-Eiferan-Etwas-Gehen -> mit-Eifer-an-Etwas-Gehen
nehment -> nehmet
sachs -> sechs
schalffe -> schlaffe
schalleitend -> schallleitend
schmeizend -> schmelzend
abge schnittenes -> abgeschnittenes
seittlicher -> seitlicher
sempercirens -> sempervirens
spühlen -> spülen
unbedentender -> unbedeutender
unerschütter -> unerschüttert
unterworjen -> unterworfen
vegetablisches -> vegetabilisches
verciehen -> verliehen
verlust -> Verlust
vorstreken -> vorstrecken
vortheilthaften -> vortheilhaften
wahrnembar ->  wahrnehmbar ;;misprint corrected
wahrnembarer -> wahrnehmbarer ;;misprint corrected
wight -> weight ;; misprint corrected
wänschend -> wünschend
wöhlriechende -> wohlriechend
überausroth -> überaus roth
überfähren -> überfáhren
überfährend -> überfáhrend
überéten -> übertreten
